0  0  1  1  1  1  1  1  1  1  1  1  1  1  1  1  1  0  0  0  
0  0  1  0  0  0  0  0  0  0  0  0  0  0  0  0  1  0  0  0  
0  0  1  0  1  1  0  3  1  1  1  5  0  1  1  0  1  0  0  0  
0  0  1  0  1  0  0  0  0  21  0  0  0  0  1  0  1  0  0  0  
0  0  1  0  1  0  0  0  0  1  0  0  0  0  1  0  1  0  0  0  
0  0  1  0  5  0  0  1  24  1  25  1  0  0  3  0  18  0  0  0
0  0  1  0  0  0  12  0  1  1  1  0  11  0  0  0  18  0  0  0
0  0  1  0  3  0  0  1  23  1  22  1  0  0  5  0  18  0  0  0
0  0  1  0  1  0  0  0  0  1  0  0  0  0  1  0  1  0  0  0  
0  0  1  0  4  0  0  0  0  1  0  0  0  0  20  0  1  0  0  0  
0  0  1  0  1  1  0  1  1  1  1  1  0  1  1  0  1  0  0  0  
0  0  1  0  0  0  0  0  0  0  0  0  0  0  0  0  1  0  0  0  
