10 0  0  0  0  0  0  0  0  0  0  0  0  0  0  0  0  0  0  0
9  0  0  0  0  0  0  0  0  0  0  0  0  0  0  0  0  0  0  9
0  0  0  0  0  0  0  0  0  0  0  0  0  0  0  0  0  0  0  0
9  0  0  0  0  20 30 31 32 33 37 34 35 36 20 0  0  0  0  9
0  0  0  0  0  0  0  0  0  0  0  0  0  0  0  0  0  0  0  0
9  0  0  4  0  0  0  0  0  0  0  0  0  0  0  0  4  0  0  9
0  0  0  1  0  0  0  0  1  1  1  1  0  0  0  0  1  0  0  0
9  0  0  1  0  0  0  0  1  18 18 1  0  0  0  0  1  0  0  9
0  0  0  3  0  0  0  0  0  0  0  0  0  0  0  0  3  0  0  0
9  0  0  0  0  0  0  0  0  0  0  0  0  0  0  0  0  0  0  9
0  0  0  0  1  1  1  3  7  7  8  8  3  1  1  1  0  0  0  0
9  0  0  0  0  0  0  0  0  0  0  0  0  0  0  0  0  0  0  9