0  0  0  0  0  0  0  0  0  0  0  0  0  0  0  0  0  0  0  0
0  0  0  0  0  0  0  0  0  0  0  0  0  0  0  0  0  0  0  0
0  0  0  0  1  25  1  5  1  5  1  6  1  6  1  26  1  0  0  0
0  0  0  0  21  0  0  0  0  0  1  0  0  0  0  0  20  0  0  0
0  0  0  0  1  0  0  0  0  0  1  0  0  0  0  0  1  0  0  0
0  0  0  0  1  0  0  11  0  0  1  0  0  12  0  0  18  0  0  0
0  0  0  0  1  0  0  0  0  0  1  0  0  0  0  0  18  0  0  0
0  0  0  0  1  0  0  0  0  0  1  0  0  0  0  0  18  0  0  0
0  0  0  0  1  0  0  0  0  0  4  0  0  0  0  0  1  0  0  0
0  0  0  0  0  0  3  1  3  1  1  22  23  24  0  0  0  0  0  0
0  0  0  0  0  0  0  0  0  0  0  0  0  0  0  0  0  0  0  0
0  0  0  0  0  0  0  0  0  0  0  0  0  0  0  0  0  0  0  0