1  1  1  1  1  1  1  1  1  1  1  1  1  1  1  1  1  1  1  1  
1  1  1  1  1  1  1  1  1  1  1  1  1  1  1  1  1  1  1  1  
1  1  1  0  0  0  0  0  21  1  21  0  0  0  0  0  1  1  1  1  
1  5  0  0  0  0  0  0  0  0  0  0  0  0  0  0  0  5  1  1  
2  0  0  0  0  0  0  0  0  0  0  0  0  0  0  0  0  0  2  1  
5  0  0  0  3  1  0  0  0  25  0  0  0  1  3  0  0  0  5  1  
2  0  0  0  1  1  0  0  0  4  0  0  0  1  1  0  0  0  2  1  
6  0  0  0  1  3  0  0  0  26  0  0  0  3  1  0  0  0  6  1  
2  0  0  0  0  0  0  0  0  0  0  0  0  0  0  0  0  0  2  1  
1  6  0  0  0  0  0  0  0  0  0  0  0  0  0  0  0  6  1  1  
1  20  0  0  0  0  0  0  0  0  0  0  0  0  0  0  0  20  1  1  
1  1  1  22  23  24  1  1  18  18  18  1  1  24  23  22  1  1  1  1  
